11111111111111111111111111111111111111
1E000000C000000C00000C00000000000C0001
10100101001000001010010011000101111101
10100100101010100010010000110101011101
1P0000000C00C00000000000000000CCC00001
11111111111111111111111111111111111111