111111111111111111111111111111
1C0000000000001000000000000001
1000000000000000000C0000001111
1101110000111100C00000000010C1
110000000011110000000000001001
1111111100011100000000C0000001
100000000000010000000111000001
10C000000000P10000000000000001
1101110000111100000C0000001111
1000C0000001000000000000001E01
100000000000000000000000001001
100000000000111111000000000001
100000000000001111000000001101
100000000000000C11100000001101
101101110000000000000000001101
10C000000000000000000000001C01
111111111111111111111111111111