111111
1C0E01
101101
100001
1P0C01
111111