111111
1E1001
110001
100001
1C0P11
111111