1111111
1C11111
1E11111
1P110C1
1111111
