1111111111111
10C10000I00C1
100000000C001
1000011100001
1P00011000C01
100C001E00001
1111111111111
1111111111111
1101101000111
1101101111011
11100I1000011
1111101011111
1111101100011
1111111111111